############
#        O #
# P     ####
#          #
#######    #
# O ##     #
#   ##     #
#          #
# X X      #
# #        #
############